11111111111111111111
11111111111111111111
11111111111111111111
11111111111111111111
11111111100011111111
11111114000011111111
11111111100411111111
11111114110011111111
11111110104011111111
11111110040041111111
11111110004001111111                   
11111111111111111111
11111111111111111111
11111111111111111111
11111111111111111111
11111111111111111111
11111111111111111111
11111111111111111111
11111111111111111111
11111111111111111111
00000000000000000000
00000000000000000000
00000000000000000000
00000000000000000000
00000000000000000000
00000000320000000000
00000000002000000000
00000000002000000000
00000002000000000000
00000000022200000000
00000000000000000000
00000000000000000000
00000000000000000000
00000000000000000000
00000000000000000000
00000000000000000000
00000000000000000000
00000000000000000000
00000000000000000000
00000000000000000000
