11111111111111111111
11111111111111110001
11111110011111110101
11100010000000000001
11101000011111101011
11100001000001100011
11111101010101111111
11111101000001111111
11111101110111111111
14000000010111111111
11111101010111111111
10000100010111111111
10000111110111111111
10000000000111111111
11041111104111111111
11111111111111111111
11111111111111111111
11111111111111111111
11111111111111111111
11111111111111111111
00000000000000000000
00000000000000000000
00000000000000000000
00000000000000000000
00000000000000000000
00000000000000000000
00000000002000000000
00000000000000000000
00000000000000000000
00000000000000000000
00000000000000000000
00000000000000000000
00223000000000000000
00000000000000000000
00000000000000000000
00000000000000000000
00000000000000000000
00000000000000000000
00000000000000000000
00000000000000000000