11111111111111111111
11111111111111111111
11111111111111111111
11111000001000041111  
11111000001000001111
11111000000000001111
11111000001000001111
11111000001111111111
11111111111111111111
11111111111111111111
11111111111111111111
11111111111111111111
11111111111111111111
11111111111111111111
11111111111111111111
11111111111111111111
11111111111111111111
11111111111111111111
11111111111111111111
11111111111111111111
00000000000000000000
00000000000000000000
00000000000000000000
00000000000000000000
00000000020000000000
00000300000000000000
00000000000000000000
00000000000000000000
00000000000000000000
00000000000000000000
00000000000000000000
00000000000000000000
00000000000000000000
00000000000000000000
00000000000000000000
00000000000000000000
00000000000000000000
00000000000000000000
00000000000000000000
00000000000000000000
